###########################
# @                       #
# $ $.          $.        #
##. $   .            $. # #
#   .  $      $         # #
#  $#         .    $.     #
#   .              $   #  -
#     .$  #     #      #  -
#   $      $  #         $.#
#   .      .     #  .     #
#                #        #
#              $.         #
#                     $.  #
#    $.                   #
#          $              #
-#         .       $  .   #
#               .         #
#       $.      $         #
#                         #
#                         #
###########################
