####################
#   #            # #
##         #   #   #
-#          #      #
-#           *     #
-#           *   # #
##                ##
#   *  *    *    ###
#                  #
#           *     ##
##      #   *    * #
#            @** # #
#             #    #
# ##    #  ###-# # #
############---#####
