###########################
#                         #
#    *           *        #
##*     *             * # #
#   *         @         # #
#   #         *     *     #
#   *                  #  -
#     *   #     #      #  -
#             #          *#
#   *      *     #  *     #
#                #        #
#               *         #
#                      *  #
#     *                   #
#                         #
-#         *          *   #
#               *         #
#        *                #
#                         #
#                         #
###########################
