----###---------
---## #-######--
-###   ##     ##
##             #
#            ###
##        *@ # #
# #          # #
#              #
#   . #   *  $##
# #            #
#        ####  #
##########--####
