-#####--######--
## # ####    #--
#       #    .##
#            $@#
#             ##
#        $    #-
#       #    #--
# #       $  ##-
##            ##
#  ### .  .    #
##   #  ### # ##
-########-#####-
