###########################
#                         #
#    *          @*        #
##*     *             * # #
#   *                   # #
#   #         *     *     #
#   *                  #  -
#     *   #     #      #  -
#             #          *#
#   *      *     #  *     #
#                #        #
#               *         #
#                      *  #
#     *                   #
#                         #
-#         *          *   #
#               *         #
#        *                #
#                         #
#                         #
###########################
