#######
#  @  #
# $ $ #
#  $  #
# ... #
#     #
#######
