##########
# @ $ .  #
#        #
#   $ .  #
#        #
#   $ .  #
##########
