############----
#   # #  # ###--
## .    #     #-
-#          # #-
-#            ##
-##   #        #
-#@$          ##
-##           ##
##             #
#  #       #   #
#   #   ##  # ##
###############-
