#############################
#                           #
#                           #
#                           #
#                           #
# @$.                       #
#   $.                      #
#    $.                     #
#     $.                    #
#      $.                   #
#       $.                  #
#        $.                 #
#         $.                #
#          $.               #
#           $.              #
#            $.             #
#             $.            #
#              $.           #
#                 $.        #
#                  $.       #
#                   $.      #
#                    $.     #
#                     $.    #
#                           #
#############################