############
#@         #
#  $   $   #
#   ###    #
#    $     #
#   ###    #
#          #
#    ...   #
############