################ 
#        $ .   # 
#       $ .    #
#              # 
#  @ $ .       #
#              # 
################ 
